000000000000000000000000000000000000000000000000000000000000
011111111111111111111111111111111111111111111111111111111110
010000100000000010000000000000001000000001000100000010000010
010000100000000010000000000000001000000001000100000010000010
011111100000000011111111111111111111111111000111111111111110
000000100011111110000000100000001000000001000100000000010000
000000100010000010000000100000001000000001000100000000010000
111111100010000010000000100000001000000001000100000000011111
111111100011100010000000100000001000000001000100000000011111
111111100000000010000000100000001000000001000100011111111111
000000100000000010000000100000001111111111000100000000010000
000000100000000010000000100000001000000001000100000000010000
011111111111111111111111111111111000000001111111111111111110
010000010000000001001000000000001000000001000000010001000010
010000010000000001001000000000001111001111000000010001000010
010000010000000001001000000000001001001001000000010001000010
011111111111111111001111111111111001111001111111111111111110
000000000000000000000000000000000000000000000000000000000000